F 76,76,76
C 99,99,99

NO ./maps/textures/text_north.png
SO ./maps/textures/text_south.png
WE ./maps/textures/text_west.png
EA ./maps/textures/text_east.png

        11111111111111111111
         1000000000000000001
11111111110W1001001001000001
1011000001000001001100011111
100100100111110111000111
10011110000010010000001
10000000000000010011111
1001111111111001001
1111000000000001011
1000000001000000001
1101111111111111111
1101
1111