NO ./path_to_the_north_texture
SO ./path_to_the_south_texture
WE ./path_to_the_west_texture
EA ./path_to_the_east_texture

F 247, 225, 250
C 240, 208, 149

111111111111111111111111111111111111111111
111111111111111111111111111111111111111111
111111111111111111111111111111111111111111
111111111111111111111111111111111111111111
111111111111000011111111110000111111111111
111111111110000001111111100000011111111111
111111111100000000111111000000001111111111
111111111100000000111111000000001111111111
111111111100000000111111000000001111111111
111111111110000000000000000000011111111111
111111111111000010000000010000111111111111
111111111111111110000000011111111111111111
111111111111111110000000011111111111111111
111111111111111110000N00011111111111111111
111111111111111110000000011111111111111111
111111111111111110000000011111111111111111
111111111111111110000000011111111111111111
111111111111111110000000011111111111111111
111111111111111110000000011111111111111111
111111111111111110000000011111111111111111
111111111111111110000000011111111111111111
111111111111111110000000011111111111111111
111111111111111110000000011111111111111111
111111111111111110000000011111111111111111
111111111111111110000000011111111111111111
111111111111111110000000011111111111111111
111111111111111110000000011111111111111111
111111111111111110000000011111111111111111
111111111111111110000000011111111111111111
111111111111111110000000011111111111111111
111111111111111110000000011111111111111111
111111111111111110000000011111111111111111
111111111111111110000000011111111111111111
111111111111111100000000001111111111111111
111111111111111100000000001111111111111111
111111111111111100000000001111111111111111
111111111111111110000000011111111111111111
111111111111111111100001111111111111111111
111111111111111111111111111111111111111111
111111111111111111111111111111111111111111
111111111111111111111111111111111111111111
111111111111111111111111111111111111111111